O N E T H R E E F I V E
T W O F O U R S E V E N
S I X E I G H T N I N E
E L E V E N T W E L V E
T E N M L E S N A T E N
T W E N T Y T W E L V E
T H I R T Y Z F O R T Y
F I F T Y O - C L O C K
O N E T H R E E F I V E
T W O F O U R S E V E N
S I X E I G H T N I N E
E L E V E N X - T E E N

A B D J M P Q Z 


THIR-TEEN or THIRT-TEEN
FOUR-TEEN
FIF-TEEN
SIX-TEEN
SEVEN-TEEN
EIGHT-TEEN
NINE-TEEN

EXPLORE ALTERNATE APPROACH, USING "FIVE AFTER TEN" INSTEAD OF "TEN O FIVE":

T W E N T Y T W E L V E
T H I R T Y E L E V E N
F O R T Y     F I F T Y 
O N E T H R E E F I V E
T W O F O U R S E V E N
S I X E I G H T N I N E
T E N 
- T E E N M F A F T E R 
O N E T H R E E F I V E
T W O F O U R S E V E N
S I X E I G H T N I N E
E L E V E N T W E L V E
T E N M F O - C L O C K